+--+--+--+--+--+--+--+
|           |        |
+  +--+--+--+--+--+  +
|  |              |  |
+  +  +--+  +--+  +  +
|  |  |     |     |  |
+  +  +  +--+--+  +  +
|  |  |  |        |  |
+  +  +  +  +--+--+  +
|     |  |          g|
+--+--+--+--+--+--+--+
